15 15
###############
I   # #       #
### # # ##### #
# # # # #     #
# # ### ### # #
# #       # # #
# # ##### # # #
# # ##### # # #
# #       # # #
# ####### # # #
#       # # # #
# ####### # # #
#         #####
## # # #      E
###############
